#######################################################
#=====================================================#
#=====================================%===============#
#=======================================%=============#
#======================================%==============#
#==========================================%==========#
#======================================%==============#
#=============================================%=======#
#======================================%===%====+=====#
#=============================================%=======#
#==%===================================%==============#
#==========================================%==========#
#======================================%==============#
#=======================================%=============#
#=====================================%===============#
#=====================================================#
#=====================================================#
#=====================================================#
#=====================================================#
#######################################################