#########################
#//////////---//////////#
#//////////---//////////#
#////////-------////////#
#////---------------////#
#-----------------------#
#-----------------------#
#-----------------------#
#-----------------------#
#-----------------------#
#-----------------------#
#-----------------------#
#-----------------------#
#-----------------------#
#-----------------------#
#-----------------------#
#/--------=====--------/#
#//--;;-=========-;;--//#
#///======%===%======///#
##########=====##########
#========\=====\========#
#===========%===========#
#=======================#		
#=======================#	
#=======================#	
#===%==============%====#
#=======================#
#########################