#########################
========================#
========================#
========================#
========================#
=====##=========##======#
========================#
==========###===========#
========================#
========================#
====##===========##=====#
=====#===========#======#
======###########=======#
========================#
========================#
========================#
========================#
========================#
========================#
#########################