#########################
========================#
========================#
========================#
========================#
=##==##=====##====##====#
=##==##=====##====##====#
=######=====##====##====#
=##==##=================#
=##==##===========##====#
========================#
========================#
========================#
========================#
========================#
========================#
========================#
========================#
========================#
#########################