#########################
#========%%%============#
#=%=====================#
#=======================#
#==%=============%======#
#=======================#
#=======================#
#=======================#
#=======================#
#==#================#===#
#==\================\===#
#==#================#===#
#=======================#
#=======================#
#=======================#
#=======================#
#=====%=================#
#==================%====#
#========%%%============#
#########################