/////####################
/////-------------------#
/////-------------------#
/////----------------;--#
#-----------------------#
#-----------------------#
#-;---------------------#
#-----------------------#
#-----------------------#
#-----------------------#
#-----------------------#
#-----------------------#
#-----------------------#
#-----------------------#
#-----------------------#
#-----------------------#
#---///-----------------#
#--/-----------------;--#
#-----------------------#
#########################